caution/warning	Edit_caution_or_warning	forms.CharField()
conditional	Add_conditional_statement	forms.CharField()
duration	Duration_Min_Time	forms.IntegerField()
How	Edit_how	forms.CharField()
how - centrifuge speed	Min_Spin_Speed	forms.IntegerField()
how - centrifuge speed	Max_Spin_Speed	forms.IntegerField()
how - machine settings	Edit_machine_settings	forms.CharField()
how - method	Edit_method	forms.CharField()
how - number of times	Specify_number_of_times	forms.IntegerField()
how - temperature	Min_Temp	forms.IntegerField()
how - temperature	Max_Temp	forms.IntegerField()
how - time	Min_Time	forms.IntegerField()
how - time	Max_Time	forms.IntegerField()
how - using machine	Specify_machine	forms.CharField()
how - using tool	Specify_tool	forms.CharField()
how - voltage	Min_Voltage	forms.IntegerField()
how - voltage	Max_Voltage	forms.IntegerField()
how - with	Add_with_what	forms.CharField()
protocol - input	Edit_input 	forms.CharField()
protocol - kit name	Edit_kit_name	forms.CharField()
protocol - output	Edit_protocol_output	forms.CharField()
protocol - type	Edit_protocol_type	forms.CharField()
remarks	Edit_remarks	forms.CharField()
step - remark	Edit_remark_about_step	forms.CharField()
step - why	Edit_why_step	forms.CharField()
what	Edit_what_remark	forms.CharField()
what - data	Edit_data	forms.CharField()
what - label	Edit_label	forms.CharField()
what - organism	Edit_orghanism_name	forms.CharField()
what - source gene	Edit_source_gene	forms.CharField()
what - source organism	Edit_source_organism	forms.CharField()
what - to	Edit_What_to	forms.CharField()
when	Specify_date	forms.DateField()
when - date	Edit_date	forms.DateField()
where	Describe_where	forms.CharField()
where - destination	Edit_destination	forms.CharField()
where - from	Edit_from	forms.CharField()
where - inside	Edit_inside_what	forms.CharField()
where - into	Edit_into	forms.CharField()
where - location	Edit_location	forms.CharField()
where - vessel	Edit_vessel_type	forms.CharField()
why	Comment_why	forms.CharField()